치코리타	풀	ㅇ
베이리프	풀	ㅇ
메가니움	풀	ㅇ
브케인	불꽃	ㅇ
마그케인	불꽃	ㅇ
블레이범	불꽃	ㅇ
리아코	물	ㅇ
엘리게이	물	ㅇ
장크로다일	물	ㅇ
구구	노말	비행
피죤	노말	비행
피죤투	노말	비행
깨비참	노말	비행
깨비드릴조	노말	비행
부우부	노말	비행
야부엉	노말	비행
꼬렛	노말	ㅇ
레트라	노말	ㅇ
꼬리선	노말	ㅇ
다꼬리	노말	ㅇ
피츄	전기	ㅇ
피카츄	전기	ㅇ
라이츄	전기	ㅇ
캐터피	벌레	ㅇ
단데기	벌레	ㅇ
버터플	벌레	비행
뿔충이	벌레	독
딱충이	벌레	독
독침붕	벌레	독
레디바	벌레	비행
레디안	벌레	비행
페이검	벌레	독
아리아도스	벌레	독
꼬마돌	바위	땅
데구리	바위	땅
딱구리	바위	땅
주뱃	독	비행
골뱃	독	비행
크로뱃	독	비행
삐	노말	ㅇ
삐삐	노말	ㅇ
픽시	노말	ㅇ
푸푸린	노말	ㅇ
푸린	노말	ㅇ
푸크린	노말	ㅇ
토케피	노말	ㅇ
토게틱	노말	비행
모래두지	땅	ㅇ
고지	땅	ㅇ
아보	독	ㅇ
아보크	독	ㅇ
노고치	노말	ㅇ
메리프	전기	ㅇ
보송송	전기	ㅇ
전룡	전기	ㅇ
우파	물	땅
누오	물	땅
고오스	고스트	독
고우스트	고스트	독
팬텀	고스트	독
안농	에스퍼	ㅇ
롱스톤	바위	땅
강철톤	강철	땅
모다피	풀	독
우츠동	풀	독
우츠보트	풀	독
통통코	풀	비행
두코	풀	비행
솜솜코	풀	비행
파라스	벌레	풀
파라섹트	벌레	풀
발챙이	물	ㅇ
슈륙챙이	물	ㅇ
강챙이	물	격투
왕구리	물	ㅇ
잉어킹	물	ㅇ
갸라도스	물	비행
콘치	물	ㅇ
왕콘치	물	ㅇ
야돈	물	에스퍼
야도란	물	에스퍼
야도킹	물	에스퍼
뚜벅초	풀	독
냄새꼬	풀	독
라플레시아	풀	독
아르코	풀	ㅇ
슬리프	에스퍼	ㅇ
슬리퍼	에스퍼	ㅇ
캐이시	에스퍼	ㅇ
윤겔라	에스퍼	ㅇ
후딘	에스퍼	ㅇ
메타몽	노말	ㅇ
피콘	벌레	ㅇ
쏘콘	벌레	강철
니드런	독	ㅇ
니드리나	독	ㅇ
니드퀸	독	땅
니드런	독	ㅇ
니드리노	독	ㅇ
니드킹	독	ㅇ
왕자리	벌레	비행
메가자리	벌레	비행
해너츠	풀	ㅇ
해루미	풀	ㅇ
아라리	풀	에스퍼
나시	풀	에스퍼
꼬지모	바위	ㅇ
마자용	에스퍼	ㅇ
콘팡	벌레	독
도나리	벌레	독
스라크	벌레	비행
핫삼	벌레	강철
쁘사이저	벌레	ㅇ
헤라크로스	벌레	격투
또가스	독	ㅇ
또도가스	독	ㅇ
질퍽이	독	ㅇ
질뻐기	독	ㅇ
코일	전기	강철
레어코일	전기	강철
찌리리공	전기	ㅇ
붐볼	전기	ㅇ
에이팜	노말	ㅇ
겟핸보숭	노말	ㅇ
블루	노말	ㅇ
그랑블루	노말	ㅇ
식스테일	불꽃	ㅇ
나인테일	불꽃	ㅇ
가디	불꽃	ㅇ
윈디	불꽃	ㅇ
노라키	노말	ㅇ
마릴	물	ㅇ
마릴리	물	ㅇ
디그다	땅	ㅇ
닥트리오	따	ㅇ
망키	격투	ㅇ
성원숭	격투	ㅇ
나옹	노말	ㅇ
페르시온	노말	ㅇ
고라파덕	물	ㅇ
골덕	물	ㅇ
알통몬	격투	ㅇ
근육몬	격투	ㅇ
괴력몬	격투	ㅇ
배루키	격투	ㅇ
시라소몬	격투	ㅇ
홍수몬	격투	ㅇ
카포에라	격투	ㅇ
키링키	노말	에스퍼
켄타로스	노말	ㅇ
밀탱크	노말	ㅇ
마그비	불꽃	ㅇ
마그마	불꽃	ㅇ
뽀뽀라	얼음	에스퍼
루주라	얼음	에스퍼
에레키드	전기	ㅇ
에레브	전기	ㅇ
마임맨	에스퍼	ㅇ
루브도	노말	ㅇ
파오리	노말	비행
네이티	에스퍼	비행
네이티오	에스퍼	비행
침바루	물	독
왕눈해	물	독
독파리	물	독
크랩	물	ㅇ
킹크랩	물	ㅇ
단단지	벌레	바위
별가사리	물	ㅇ
아쿠스타	물	에스퍼
셀러	물
파르셀	물	얼음
코산호	물	바위
총어	물	ㅇ
대포무노	물	ㅇ
초라기	물	전기
랜턴	물	전기
츄츄	물	ㅇ
쥬래곤	물	얼음
내루미	노말	ㅇ
내룸벨트	노말	ㅇ
덩쿠리	풀	ㅇ
덩쿠림보	풀	ㅇ
이브이	노말	ㅇ
샤미드	물	ㅇ
쥬피썬더	전기	ㅇ
부스터	불꽃	ㅇ
에브이	에스퍼	ㅇ
블래키	악	ㅇ
쏘드라	물	ㅇ
시드라	물	ㅇ
킹드라	물	드래곤
글라이거	땅	비행
딜리버드	얼음	비행
꾸꾸리	얼음	땅
메꾸리	얼음	땅
맘모꾸리	얼음	땅
깜지곰	노말	ㅇ
링곰	노말	ㅇ
코코리	땅	ㅇ
코리갑	땅	ㅇ
만타인	물	비행
무장조	강철	비행
두두	노말	비행
두트리오	노말	비행
포니타	불꽃	ㅇ
날쌩마	불꽃	ㅇ
탕구리	땅	ㅇ
텅구리	땅	ㅇ
캥카	노말	ㅇ
뿔카노	땅	바위
코뿌리	땅	바위
니로우	악	비행
델빌	악	불꽃
헬가	악	불꽃
마그마그	불꽃	ㅇ
마그카르고	불꽃	바위
포푸니	악	얼음
무우마	고스트	ㅇ
폴리곤	노말	ㅇ
폴리곤2	노말	ㅇ
럭키	노말	ㅇ
해피너스	노말	ㅇ
라프라스	물	얼음
암나이트	바위	물
암스타	바위	물
투구	바위	물
투구푸스	바위	물
프테라	바위	비행
잠만보	노말	ㅇ
이상해씨	풀	독
이상해풀	풀	독
이상해꽃	풀	독
파이리	불꽃	ㅇ
리자드	불꽃	비행
꼬부기	물	ㅇ
어니부기	물	ㅇ
거북왕	물	ㅇ
프리져	얼음	비행
썬더	전기	비행
파이어	불꽃	비행
라이코	전기	ㅇ
앤테이	불꽃	ㅇ
스이쿤	물	ㅇ
미뇽	드래곤	ㅇ
신뇽	드래곤	ㅇ
망나뇽	드래곤	비행
애버라스	바위	땅
데기라스	바위	땅
마기라스	바위	악
루기아	에스퍼	비행
칠색조	불꽃	비행
뮤츠	에스퍼	ㅇ
뮤	에스퍼	ㅇ
세레비	에스퍼	풀